You are a wizard, can you find your wand and go to Hogwarts?

Wand Quest
An Interactive Fiction by N.
Release 1 / Serial number 191202 / Inform 7 build 6M62 (I6/v6.34 lib 6/12N) 

Bedroom
you are in your room, it is very messy

clothes are on the floor.

There is a desk with some papers on it

>east
Office
 Here, the owner of the house does very important work, the owner is here and says "you know you are not allowed to enter this room according to the rules"... 

You can see owner here.

>opposite
That's not a verb I recognise.

>turn
What do you want to turn?

>right
You can't see any such thing.

>turn left
You can't see any such thing.

>turn
What do you want to turn?

>east
You must name something more substantial.

>shoer
That's not a verb I recognise.

>shower
That's not a verb I recognise.

>furniture
That's not a verb I recognise.

>Stateroom
That's not a verb I recognise.

>west
Stateroom
Staterooms aboard a spaceship, even one as luxurious as the Thaleia, are tight, cramped affairs, and this one is no exception. There is barely enough room for you and the furniture. The door to the hallway is locked tight for now. East is your bathroom.

You can see a leaflet and a bed here.

Robutler rattles into the room, following you.

>north
You can't go that way.

>west
You can't go that way.

>east
Bathroom
Like your stateroom in smallness, only moreso. There is a mirror on one wall.

Opposite the mirror is the shower, which is closed.

Robutler rattles into the room, following you.

>north
You can't go that way.

>south
You can't go that way.

>right
That's not a verb I recognise.

>left
That's not a verb I recognise.

>up
You can't go that way.

>bed
That's not a verb I recognise.

>west
Stateroom
Staterooms aboard a spaceship, even one as luxurious as the Thaleia, are tight, cramped affairs, and this one is no exception. There is barely enough room for you and the furniture. The door to the hallway is locked tight for now. East is your bathroom.

You can see a leaflet and a bed here.

Robutler rattles into the room, following you.

>west
You can't go that way.

You realize that you are becoming exhausted.

>west
You can't go that way.

* * *

>east
Bathroom
Like your stateroom in smallness, only moreso. There is a mirror on one wall.

Opposite the mirror is the shower, which is closed.

Robutler rattles into the room, following you.

>east
You can't go that way.

>east
You can't go that way.

>turn
What do you want to turn?

* * *

>right
You can't see any such thing.

>turn right
You can't see any such thing.

>turn
What do you want to turn?

>west
You must name something more substantial.

>turn east
You must name something more substantial.

>turn
What do you want to turn?

* * *

>east
You must name something more substantial.

>turn bathroom
You can't see any such thing.

>turn bedroom
You can't see any such thing.

>stateroom
That's not a verb I recognise.

* * *

>east
Office
 Here, the owner of the house does very important work, the owner is here and says "you know you are not allowed to enter this room according to the rules"... 

You can see owner here.

>turn
What do you want to turn?

>left
You can't see any such thing.

>shower
That's not a verb I recognise.

>east
You can't go that way.

>west
Stateroom
Staterooms aboard a spaceship, even one as luxurious as the Thaleia, are tight, cramped affairs, and this one is no exception. There is barely enough room for you and the furniture. The door to the hallway is locked tight for now. East is your bathroom.

You can see a leaflet and a bed here.

Robutler rattles into the room, following you.

* * *

>north
You can't go that way.

>east
Bathroom
Like your stateroom in smallness, only moreso. There is a mirror on one wall.

Opposite the mirror is the shower, which is closed.

Robutler rattles into the room, following you.

* * *

>west
Stateroom
Staterooms aboard a spaceship, even one as luxurious as the Thaleia, are tight, cramped affairs, and this one is no exception. There is barely enough room for you and the furniture. The door to the hallway is locked tight for now. East is your bathroom.

You can see a leaflet and a bed here.

Robutler rattles into the room, following you.

>west
You can't go that way.

>furniture
That's not a verb I recognise.

>bed
That's not a verb I recognise.

>leaflet
That's not a verb I recognise.

>mirror
That's not a verb I recognise.

>east
Bathroom
Like your stateroom in smallness, only moreso. There is a mirror on one wall.

Opposite the mirror is the shower, which is closed.

Robutler rattles into the room, following you.

>mirror
That's not a verb I recognise.

>moreso
That's not a verb I recognise.

>here
That's not a verb I recognise.

>shower
That's not a verb I recognise.

>open shower
It isn't something you can open.

>close shower
It isn't something you can close.

You realize that you are becoming exhausted.

>man
That's not a verb I recognise.

>Robulter
That's not a verb I recognise.

>robot
That's not a verb I recognise.

>butler
That's not a verb I recognise.

* * *

>east
Office
 Here, the owner of the house does very important work, the owner is here and says "you know you are not allowed to enter this room according to the rules"... 

You can see owner here.

>west
Bedroom
you are in your room, it is very messy

clothes are on the floor.

There is a desk with some papers on it

>examine desk
You check under the papers on the desk, there are only pens, you can't see a wand.

>west
You can't go that way.

>east
Office
 Here, the owner of the house does very important work, the owner is here and says "you know you are not allowed to enter this room according to the rules"... 

You can see owner here.

>east
You can't go that way.

The owner has left the office.

>west
Bedroom
you are in your room, it is very messy

clothes are on the floor.

There is a desk with some papers on it

>east
Office
 Very white clean room, nothing to see.

>west
Bedroom
you are in your room, it is very messy

clothes are on the floor.

There is a desk with some papers on it

>examine clothes
Very smelly clothes, it's probably not there.

>examine clothes
you hate yourself for not doing laundry, you keep looking but no luck so far

>examine clothes
    *** FOUND THE WAND! I'M GOING TO HOGWARTS..! Then you realize how great it would be... ***

Would you like to RESTART, RESTORE a saved game, QUIT or UNDO the last command?

>RESTART
You are a wizard, can you find your wand and go to Hogwarts?

Wand Quest
An Interactive Fiction by N.
Release 1 / Serial number 191202 / Inform 7 build 6M62 (I6/v6.34 lib 6/12N) 

Bedroom
you are in your room, it is very messy

clothes are on the floor.

There is a desk with some papers on it

>examine clothes
Very smelly clothes, it's probably not there.

>examine vclothes
You can't see any such thing.

>examine clothes
you hate yourself for not doing laundry, you keep looking but no luck so far

* * *

>west
Bedroom
you are in your room, it is very messy

clothes are on the floor.

There is a desk with some papers on it

>examine papers
You can't see any such thing.

>examine desk
You check under the papers on the desk, there are only pens, you can't see a wand.

* * *

>west
You can't go that way.

>east
Office
Here, the owner of the house does very important work, the owner is here and says "you know you are not allowed to enter this room according to the rules"... 

You can see owner here.

>east
You can't go that way.

The owner has left the office.

* * *

>west
Bedroom
you are in your room, it is very messy

clothes are on the floor.

There is a desk with some papers on it

>east
Office
Here, the owner of the house does very important work, the owner is here and says "you know you are not allowed to enter this room according to the rules"... Very white clean room, nothing to see.

* * *

>west
Bedroom
you are in your room, it is very messy

clothes are on the floor.

There is a desk with some papers on it

>left
That's not a verb I recognise.

>north
You can't go that way.

>south
Dining Room
The humans are all in the next room.  You smell some tasty food from on top of the table. 

The table is too high for you to see on top, but you can smell treats!

It is a wide chair.  Uncle Carl usually sits there

>chair
That's not a verb I recognise.

>examine chair
The chair is pushed back from the table.  It is tall enough that you can climb on it.

>climb chair
You are on top of the table.  Such tasty food is here!

Momlady moves the turkey from the kitchen to the table in the dining room.

>north
kitchen
It is bright and shiny in here.  Your owner loves to make tasty treats in here.  Several of the humans are here.

Uncle Carl is a nice man.  Sometimes he has a treat.

Momlady is a nice person.  She makes food.

Aunt Judy never has treats.  What more needs to be said?

>climb table
You can't see any such thing.

>examine table
You can't see any such thing.

>smell table
You can't see any such thing.

>east
You can't go that way.

>south
Dining Room
The humans are all in the next room.  You smell some tasty food from on top of the table. Something tasty is on the table, you are sure of it.

Turkey!  It is like giant chicken!  Surely the humans will not mind if you take a small taste…

The table is too high for you to see on top, but you can smell treats!

It is a wide chair.  Uncle Carl usually sits there

>examine table
You see nothing special about the table.

>climb table
Little is to be achieved by that.

>examine chair
The chair is pushed back from the table.  It is tall enough that you can climb on it.

>climb chair
You are on top of the table.  Such tasty food is here!

>find turkey
That's not a verb I recognise.

>examine table
You see nothing special about the table.

>examine uncle karl
You can't see any such thing.

>ask uncle karl
You can't see any such thing.

>examine aunt hudy
You can't see any such thing.

>examine aunt judy
You can't see any such thing.

>eat turker
You can't see any such thing.

>eat
What do you want to eat?

>turkey
You take a small little bite.  It is good!  You eat more.  One of the little humans comes into the room.  "Rex! Bad dog!  Mom, Rex is eating the turkey!"
You have been a BAD DOG.  You hang your head in shame and climb down the chair to the floor, still chewing Turkey.  One of the big humans comes in with a broom.  "Bad dog! Outside.

    *** It is cold out here!  And all of the humans are inside without you!  Life is unfair….  Hey, a squirrel!!! ***

Would you like to RESTART, RESTORE a saved game, QUIT or UNDO the last command?

>RESTART
Your name is Rex, the family dog.  Today is a special day!  Many people are here today visiting your humans.  And there are many tasty treats and good smells!  Hmm…  How can you get something to eat?

Turkey Quest
An Interactive Fiction by Thomas H. Austin
Release 1 / Serial number 191202 / Inform 7 build 6M62 (I6/v6.34 lib 6/12N) SD

kitchen
It is bright and shiny in here.  Your owner loves to make tasty treats in here.  Several of the humans are here.

Turkey!  It is like giant chicken!  Surely the humans will not mind if you take a small taste…

Uncle Carl is a nice man.  Sometimes he has a treat.

Momlady is a nice person.  She makes food.

Aunt Judy never has treats.  What more needs to be said?

>eat turkey
You move towards the turkey, but one of the humans says "bad Rex!" and slaps you on the nose.  You slink away, knowing that you were a BAD DOG.

>eat chewtoy
You can't see any such thing.

>climb chair
You can't see any such thing.

>examine table
You can't see any such thing.

* * *

You are a wizard, can you find your wand and go to Hogwarts?

Wand Quest
An Interactive Fiction by N.
Release 1 / Serial number 191202 / Inform 7 build 6M62 (I6/v6.34 lib 6/12N) 

Bedroom
you are in your room, it is very messy

clothes are on the floor.

There is a desk with some papers on it

>examine desk
You check under the papers on the desk, there are only pens, you can't see a wand.

>examine clothes
Very smelly clothes, it's probably not there."
you hate yourself for not doing laundry, you keep looking but no luck so far

    *** FOUND THE WAND! I'M GOING TO HOGWARTS..! Then you realize how great Hogwarts would be... ***

Would you like to RESTART, RESTORE a saved game, QUIT or UNDO the last command?

* * *

You are a wizard, can you find your wand and go to Hogwarts?

Wand Quest
An Interactive Fiction by N.
Release 1 / Serial number 191202 / Inform 7 build 6M62 (I6/v6.34 lib 6/12N) 

Bedroom
you are in your room, it is very messy

clothes are on the floor.

There is a desk with some papers on it

>open door
You can't see any such thing.

>hallway
That's not a verb I recognise.

>bed
That's not a verb I recognise.

>Robulter
That's not a verb I recognise.

>find bulter
That's not a verb I recognise.

>turn
What do you want to turn?

>mirror
You can't see any such thing.

>turn left
You can't see any such thing.

>east
Bathroom
Like your stateroom in smallness, only moreso. There is a mirror on one wall.

Opposite the mirror is the shower, which is closed.

Robutler rattles into the room, following you.

>opem
That's not a verb I recognise.

>opem
That's not a verb I recognise.

>open
What do you want to open?

>shower
It isn't something you can open.

>shower
That's not a verb I recognise.

>use shower
That's not a verb I recognise.